"filename", "language", "JSON with Comments", "JavaScript", "Markdown", "JSON", "PostCSS", "comment", "blank", "total"
"c:\Users\Blessan Corley\My Projects\Fixly old\AUTH_CLEANUP_REPORT.md", "Markdown", 0, 0, 137, 0, 0, 0, 56, 193
"c:\Users\Blessan Corley\My Projects\Fixly old\AUTH_IMPLEMENTATION_REPORT.md", "Markdown", 0, 0, 261, 0, 0, 0, 68, 329
"c:\Users\Blessan Corley\My Projects\Fixly old\AUTH_UX_FIXES_REPORT.md", "Markdown", 0, 0, 215, 0, 0, 0, 53, 268
"c:\Users\Blessan Corley\My Projects\Fixly old\CLAUDE.md", "Markdown", 0, 0, 308, 0, 0, 0, 68, 376
"c:\Users\Blessan Corley\My Projects\Fixly old\LOCATION_SYSTEM_ENHANCEMENT_REPORT.md", "Markdown", 0, 0, 248, 0, 0, 0, 73, 321
"c:\Users\Blessan Corley\My Projects\Fixly old\LOCATION_SYSTEM_IMPLEMENTATION.md", "Markdown", 0, 0, 199, 0, 0, 0, 53, 252
"c:\Users\Blessan Corley\My Projects\Fixly old\MESSAGING_SYSTEM_SUMMARY.md", "Markdown", 0, 0, 167, 0, 0, 0, 51, 218
"c:\Users\Blessan Corley\My Projects\Fixly old\OPTIMIZATION_SUMMARY.md", "Markdown", 0, 0, 135, 0, 0, 0, 44, 179
"c:\Users\Blessan Corley\My Projects\Fixly old\PRODUCTION_READINESS_REPORT.md", "Markdown", 0, 0, 193, 0, 0, 0, 50, 243
"c:\Users\Blessan Corley\My Projects\Fixly old\README.md", "Markdown", 0, 0, 70, 0, 0, 0, 24, 94
"c:\Users\Blessan Corley\My Projects\Fixly old\REALTIME_SYSTEM.md", "Markdown", 0, 0, 212, 0, 0, 0, 56, 268
"c:\Users\Blessan Corley\My Projects\Fixly old\REDIS_SOCKET_INTEGRATION_FIX.md", "Markdown", 0, 0, 224, 0, 0, 0, 75, 299
"c:\Users\Blessan Corley\My Projects\Fixly old\REVIEW_SYSTEM_DOCUMENTATION.md", "Markdown", 0, 0, 329, 0, 0, 0, 88, 417
"c:\Users\Blessan Corley\My Projects\Fixly old\SETUP_GUIDE.md", "Markdown", 0, 0, 223, 0, 0, 0, 68, 291
"c:\Users\Blessan Corley\My Projects\Fixly old\SKILLS_CONSOLIDATION_REPORT.md", "Markdown", 0, 0, 170, 0, 0, 0, 43, 213
"c:\Users\Blessan Corley\My Projects\Fixly old\app\about\page.js", "JavaScript", 0, 436, 0, 0, 0, 1, 24, 461
"c:\Users\Blessan Corley\My Projects\Fixly old\app\admin\page.js", "JavaScript", 0, 35, 0, 0, 0, 4, 5, 44
"c:\Users\Blessan Corley\My Projects\Fixly old\app\admin\setup\page.js", "JavaScript", 0, 197, 0, 0, 0, 1, 18, 216
"c:\Users\Blessan Corley\My Projects\Fixly old\app\api\admin\dashboard\route.js", "JavaScript", 0, 140, 0, 0, 0, 15, 24, 179
"c:\Users\Blessan Corley\My Projects\Fixly old\app\api\admin\jobs\route.js", "JavaScript", 0, 217, 0, 0, 0, 14, 29, 260
"c:\Users\Blessan Corley\My Projects\Fixly old\app\api\admin\setup\route.js", "JavaScript", 0, 83, 0, 0, 0, 7, 14, 104
"c:\Users\Blessan Corley\My Projects\Fixly old\app\api\admin\stats\route.js", "JavaScript", 0, 76, 0, 0, 0, 7, 13, 96
"c:\Users\Blessan Corley\My Projects\Fixly old\app\api\admin\users\[userId]\[action]\route.js", "JavaScript", 0, 129, 0, 0, 0, 10, 22, 161
"c:\Users\Blessan Corley\My Projects\Fixly old\app\api\admin\users\route.js", "JavaScript", 0, 206, 0, 0, 0, 13, 28, 247
"c:\Users\Blessan Corley\My Projects\Fixly old\app\api\admin\verification\route.js", "JavaScript", 0, 128, 0, 0, 0, 11, 23, 162
"c:\Users\Blessan Corley\My Projects\Fixly old\app\api\analytics\track\route.js", "JavaScript", 0, 22, 0, 0, 0, 3, 3, 28
"c:\Users\Blessan Corley\My Projects\Fixly old\app\api\auth\[...nextauth]\route.js", "JavaScript", 0, 4, 0, 0, 0, 1, 2, 7
"c:\Users\Blessan Corley\My Projects\Fixly old\app\api\auth\check-username\route.js", "JavaScript", 0, 304, 0, 0, 0, 34, 54, 392
"c:\Users\Blessan Corley\My Projects\Fixly old\app\api\auth\forgot-password\route.js", "JavaScript", 0, 93, 0, 0, 0, 10, 18, 121
"c:\Users\Blessan Corley\My Projects\Fixly old\app\api\auth\reset-password\route.js", "JavaScript", 0, 126, 0, 0, 0, 14, 25, 165
"c:\Users\Blessan Corley\My Projects\Fixly old\app\api\auth\send-otp\route.js", "JavaScript", 0, 196, 0, 0, 0, 20, 31, 247
"c:\Users\Blessan Corley\My Projects\Fixly old\app\api\auth\signup\route.js", "JavaScript", 0, 624, 0, 0, 0, 71, 107, 802
"c:\Users\Blessan Corley\My Projects\Fixly old\app\api\auth\signup\test.js", "JavaScript", 0, 19, 0, 0, 0, 1, 2, 22
"c:\Users\Blessan Corley\My Projects\Fixly old\app\api\auth\update-session\route.js", "JavaScript", 0, 43, 0, 0, 0, 4, 8, 55
"c:\Users\Blessan Corley\My Projects\Fixly old\app\api\auth\verify-otp\route.js", "JavaScript", 0, 66, 0, 0, 0, 7, 13, 86
"c:\Users\Blessan Corley\My Projects\Fixly old\app\api\auth\verify-phone-firebase\route.js", "JavaScript", 0, 94, 0, 0, 0, 9, 18, 121
"c:\Users\Blessan Corley\My Projects\Fixly old\app\api\contact\route.js", "JavaScript", 0, 133, 0, 0, 0, 12, 16, 161
"c:\Users\Blessan Corley\My Projects\Fixly old\app\api\cron\automated-messages\route.js", "JavaScript", 0, 31, 0, 0, 0, 5, 8, 44
"c:\Users\Blessan Corley\My Projects\Fixly old\app\api\cron\cleanup\route.js", "JavaScript", 0, 99, 0, 0, 0, 8, 16, 123
"c:\Users\Blessan Corley\My Projects\Fixly old\app\api\cron\notifications\route.js", "JavaScript", 0, 33, 0, 0, 0, 10, 10, 53
"c:\Users\Blessan Corley\My Projects\Fixly old\app\api\dashboard\recent-jobs\route.js", "JavaScript", 0, 115, 0, 0, 0, 10, 21, 146
"c:\Users\Blessan Corley\My Projects\Fixly old\app\api\dashboard\stats\route.js", "JavaScript", 0, 557, 0, 0, 0, 37, 54, 648
"c:\Users\Blessan Corley\My Projects\Fixly old\app\api\disputes\[disputeId]\route.js", "JavaScript", 0, 269, 0, 0, 0, 17, 44, 330
"c:\Users\Blessan Corley\My Projects\Fixly old\app\api\disputes\route.js", "JavaScript", 0, 358, 0, 0, 0, 26, 54, 438
"c:\Users\Blessan Corley\My Projects\Fixly old\app\api\fixer\applications\route.js", "JavaScript", 0, 101, 0, 0, 0, 9, 15, 125
"c:\Users\Blessan Corley\My Projects\Fixly old\app\api\jobs\[jobId]\applications\route.js", "JavaScript", 0, 218, 0, 0, 0, 19, 31, 268
"c:\Users\Blessan Corley\My Projects\Fixly old\app\api\jobs\[jobId]\applications\withdraw\route.js", "JavaScript", 0, 47, 0, 0, 0, 4, 10, 61
"c:\Users\Blessan Corley\My Projects\Fixly old\app\api\jobs\[jobId]\apply\route.js", "JavaScript", 0, 434, 0, 0, 0, 27, 58, 519
"c:\Users\Blessan Corley\My Projects\Fixly old\app\api\jobs\[jobId]\comments\[commentId]\edit\route.js", "JavaScript", 0, 251, 0, 0, 0, 11, 35, 297
"c:\Users\Blessan Corley\My Projects\Fixly old\app\api\jobs\[jobId]\comments\[commentId]\like\route.js", "JavaScript", 0, 218, 0, 0, 0, 11, 30, 259
"c:\Users\Blessan Corley\My Projects\Fixly old\app\api\jobs\[jobId]\comments\[commentId]\react\route.js", "JavaScript", 0, 231, 0, 0, 0, 11, 31, 273
"c:\Users\Blessan Corley\My Projects\Fixly old\app\api\jobs\[jobId]\comments\route.js", "JavaScript", 0, 501, 0, 0, 0, 23, 74, 598
"c:\Users\Blessan Corley\My Projects\Fixly old\app\api\jobs\[jobId]\comments\stream\route.js", "JavaScript", 0, 108, 0, 0, 0, 8, 13, 129
"c:\Users\Blessan Corley\My Projects\Fixly old\app\api\jobs\[jobId]\like\route.js", "JavaScript", 0, 141, 0, 0, 0, 5, 22, 168
"c:\Users\Blessan Corley\My Projects\Fixly old\app\api\jobs\[jobId]\messages\route.js", "JavaScript", 0, 172, 0, 0, 0, 12, 31, 215
"c:\Users\Blessan Corley\My Projects\Fixly old\app\api\jobs\[jobId]\rating\route.js", "JavaScript", 0, 102, 0, 0, 0, 10, 19, 131
"c:\Users\Blessan Corley\My Projects\Fixly old\app\api\jobs\[jobId]\review\route.js", "JavaScript", 0, 164, 0, 0, 0, 11, 25, 200
"c:\Users\Blessan Corley\My Projects\Fixly old\app\api\jobs\[jobId]\reviews\status\route.js", "JavaScript", 0, 75, 0, 0, 0, 5, 12, 92
"c:\Users\Blessan Corley\My Projects\Fixly old\app\api\jobs\[jobId]\route.js", "JavaScript", 0, 627, 0, 0, 0, 53, 115, 795
"c:\Users\Blessan Corley\My Projects\Fixly old\app\api\jobs\[jobId]\status\route.js", "JavaScript", 0, 368, 0, 0, 0, 25, 54, 447
"c:\Users\Blessan Corley\My Projects\Fixly old\app\api\jobs\[jobId]\view\route.js", "JavaScript", 0, 112, 0, 0, 0, 6, 17, 135
"c:\Users\Blessan Corley\My Projects\Fixly old\app\api\jobs\browse\route-fixed.js", "JavaScript", 0, 267, 0, 0, 0, 19, 31, 317
"c:\Users\Blessan Corley\My Projects\Fixly old\app\api\jobs\browse\route.js", "JavaScript", 0, 267, 0, 0, 0, 19, 31, 317
"c:\Users\Blessan Corley\My Projects\Fixly old\app\api\jobs\drafts\[draftId]\route.js", "JavaScript", 0, 83, 0, 0, 0, 4, 12, 99
"c:\Users\Blessan Corley\My Projects\Fixly old\app\api\jobs\drafts\route.js", "JavaScript", 0, 260, 0, 0, 0, 15, 39, 314
"c:\Users\Blessan Corley\My Projects\Fixly old\app\api\jobs\post\route.js", "JavaScript", 0, 462, 0, 0, 0, 41, 57, 560
"c:\Users\Blessan Corley\My Projects\Fixly old\app\api\jobs\stats\route.js", "JavaScript", 0, 129, 0, 0, 0, 14, 19, 162
"c:\Users\Blessan Corley\My Projects\Fixly old\app\api\jobs\upload-media\route.js", "JavaScript", 0, 219, 0, 0, 0, 14, 32, 265
"c:\Users\Blessan Corley\My Projects\Fixly old\app\api\location\cache\route.js", "JavaScript", 0, 159, 0, 0, 0, 9, 25, 193
"c:\Users\Blessan Corley\My Projects\Fixly old\app\api\location\reverse-geocode\route.js", "JavaScript", 0, 122, 0, 0, 0, 9, 21, 152
"c:\Users\Blessan Corley\My Projects\Fixly old\app\api\location\route.js", "JavaScript", 0, 255, 0, 0, 0, 18, 46, 319
"c:\Users\Blessan Corley\My Projects\Fixly old\app\api\messages\[jobId]\allowed\route.js", "JavaScript", 0, 57, 0, 0, 0, 3, 10, 70
"c:\Users\Blessan Corley\My Projects\Fixly old\app\api\messages\route.js", "JavaScript", 0, 254, 0, 0, 0, 22, 49, 325
"c:\Users\Blessan Corley\My Projects\Fixly old\app\api\reviews\[reviewId]\helpful\route.js", "JavaScript", 0, 48, 0, 0, 0, 5, 8, 61
"c:\Users\Blessan Corley\My Projects\Fixly old\app\api\reviews\route.js", "JavaScript", 0, 304, 0, 0, 0, 23, 48, 375
"c:\Users\Blessan Corley\My Projects\Fixly old\app\api\reviews\submit\route.js", "JavaScript", 0, 362, 0, 0, 0, 31, 54, 447
"c:\Users\Blessan Corley\My Projects\Fixly old\app\api\search\suggestions\route.js", "JavaScript", 0, 102, 0, 0, 0, 7, 16, 125
"c:\Users\Blessan Corley\My Projects\Fixly old\app\api\subscription\create-order\route.js", "JavaScript", 0, 146, 0, 0, 0, 7, 18, 171
"c:\Users\Blessan Corley\My Projects\Fixly old\app\api\subscription\fixer\route.js", "JavaScript", 0, 202, 0, 0, 0, 13, 36, 251
"c:\Users\Blessan Corley\My Projects\Fixly old\app\api\subscription\hirer\route.js", "JavaScript", 0, 218, 0, 0, 0, 14, 41, 273
"c:\Users\Blessan Corley\My Projects\Fixly old\app\api\subscription\verify-payment\route.js", "JavaScript", 0, 218, 0, 0, 0, 14, 26, 258
"c:\Users\Blessan Corley\My Projects\Fixly old\app\api\test\ably\route.js", "JavaScript", 0, 166, 0, 0, 0, 5, 19, 190
"c:\Users\Blessan Corley\My Projects\Fixly old\app\api\test\draft-functionality\route.js", "JavaScript", 0, 90, 0, 0, 0, 8, 14, 112
"c:\Users\Blessan Corley\My Projects\Fixly old\app\api\upload\route.js", "JavaScript", 0, 86, 0, 0, 0, 7, 11, 104
"c:\Users\Blessan Corley\My Projects\Fixly old\app\api\user\change-password\route.js", "JavaScript", 0, 84, 0, 0, 0, 11, 17, 112
"c:\Users\Blessan Corley\My Projects\Fixly old\app\api\user\check-email\route.js", "JavaScript", 0, 52, 0, 0, 0, 3, 10, 65
"c:\Users\Blessan Corley\My Projects\Fixly old\app\api\user\check-username\route.js", "JavaScript", 0, 57, 0, 0, 0, 3, 11, 71
"c:\Users\Blessan Corley\My Projects\Fixly old\app\api\user\earnings\route.js", "JavaScript", 0, 87, 0, 0, 0, 7, 14, 108
"c:\Users\Blessan Corley\My Projects\Fixly old\app\api\user\fixer-settings\route.js", "JavaScript", 0, 228, 0, 0, 0, 17, 32, 277
"c:\Users\Blessan Corley\My Projects\Fixly old\app\api\user\location\history\route.js", "JavaScript", 0, 103, 0, 0, 0, 4, 18, 125
"c:\Users\Blessan Corley\My Projects\Fixly old\app\api\user\location\route.js", "JavaScript", 0, 228, 0, 0, 0, 23, 45, 296
"c:\Users\Blessan Corley\My Projects\Fixly old\app\api\user\notifications\read\route.js", "JavaScript", 0, 72, 0, 0, 0, 7, 14, 93
"c:\Users\Blessan Corley\My Projects\Fixly old\app\api\user\notifications\route.js", "JavaScript", 0, 209, 0, 0, 0, 16, 35, 260
"c:\Users\Blessan Corley\My Projects\Fixly old\app\api\user\preferences\route.js", "JavaScript", 0, 32, 0, 0, 0, 1, 6, 39
"c:\Users\Blessan Corley\My Projects\Fixly old\app\api\user\privacy\route.js", "JavaScript", 0, 200, 0, 0, 0, 22, 38, 260
"c:\Users\Blessan Corley\My Projects\Fixly old\app\api\user\profile-photo\route.js", "JavaScript", 0, 149, 0, 0, 0, 12, 20, 181
"c:\Users\Blessan Corley\My Projects\Fixly old\app\api\user\profile\[username]\route.js", "JavaScript", 0, 76, 0, 0, 0, 9, 13, 98
"c:\Users\Blessan Corley\My Projects\Fixly old\app\api\user\profile\route.js", "JavaScript", 0, 355, 0, 0, 0, 26, 49, 430
"c:\Users\Blessan Corley\My Projects\Fixly old\app\api\user\profile\search\route.js", "JavaScript", 0, 132, 0, 0, 0, 13, 18, 163
"c:\Users\Blessan Corley\My Projects\Fixly old\app\api\user\push-subscription\route.js", "JavaScript", 0, 121, 0, 0, 0, 4, 20, 145
"c:\Users\Blessan Corley\My Projects\Fixly old\app\api\user\update-email\route.js", "JavaScript", 0, 106, 0, 0, 0, 9, 19, 134
"c:\Users\Blessan Corley\My Projects\Fixly old\app\api\user\update-phone\route.js", "JavaScript", 0, 113, 0, 0, 0, 10, 20, 143
"c:\Users\Blessan Corley\My Projects\Fixly old\app\api\user\update-username\route.js", "JavaScript", 0, 111, 0, 0, 0, 10, 20, 141
"c:\Users\Blessan Corley\My Projects\Fixly old\app\api\user\upload-photo\route.js", "JavaScript", 0, 70, 0, 0, 0, 84, 14, 168
"c:\Users\Blessan Corley\My Projects\Fixly old\app\api\user\verification\apply\route.js", "JavaScript", 0, 146, 0, 0, 0, 17, 23, 186
"c:\Users\Blessan Corley\My Projects\Fixly old\app\api\validate-content\route.js", "JavaScript", 0, 66, 0, 0, 0, 4, 11, 81
"c:\Users\Blessan Corley\My Projects\Fixly old\app\auth\error\page.js", "JavaScript", 0, 192, 0, 0, 0, 0, 15, 207
"c:\Users\Blessan Corley\My Projects\Fixly old\app\auth\forgot-password\page.js", "JavaScript", 0, 565, 0, 0, 0, 12, 49, 626
"c:\Users\Blessan Corley\My Projects\Fixly old\app\auth\reset-password\page.js", "JavaScript", 0, 252, 0, 0, 0, 1, 24, 277
"c:\Users\Blessan Corley\My Projects\Fixly old\app\auth\signin\page.js", "JavaScript", 0, 328, 0, 0, 0, 10, 34, 372
"c:\Users\Blessan Corley\My Projects\Fixly old\app\auth\signup\page.js", "JavaScript", 0, 1651, 0, 0, 0, 109, 201, 1961
"c:\Users\Blessan Corley\My Projects\Fixly old\app\auth\verified\page.js", "JavaScript", 0, 161, 0, 0, 0, 1, 14, 176
"c:\Users\Blessan Corley\My Projects\Fixly old\app\auth\verify-account\page.js", "JavaScript", 0, 454, 0, 0, 0, 14, 36, 504
"c:\Users\Blessan Corley\My Projects\Fixly old\app\contact\page.js", "JavaScript", 0, 477, 0, 0, 0, 3, 31, 511
"c:\Users\Blessan Corley\My Projects\Fixly old\app\cookies\page.js", "JavaScript", 0, 313, 0, 0, 0, 0, 18, 331
"c:\Users\Blessan Corley\My Projects\Fixly old\app\dashboard\admin\page.js", "JavaScript", 0, 805, 0, 0, 0, 8, 47, 860
"c:\Users\Blessan Corley\My Projects\Fixly old\app\dashboard\applications\page.js", "JavaScript", 0, 339, 0, 0, 0, 0, 32, 371
"c:\Users\Blessan Corley\My Projects\Fixly old\app\dashboard\browse-jobs\page.js", "JavaScript", 0, 570, 0, 0, 0, 23, 60, 653
"c:\Users\Blessan Corley\My Projects\Fixly old\app\dashboard\disputes\[disputeId]\page.js", "JavaScript", 0, 757, 0, 0, 0, 2, 67, 826
"c:\Users\Blessan Corley\My Projects\Fixly old\app\dashboard\disputes\page.js", "JavaScript", 0, 413, 0, 0, 0, 0, 32, 445
"c:\Users\Blessan Corley\My Projects\Fixly old\app\dashboard\earnings\page.js", "JavaScript", 0, 477, 0, 0, 0, 5, 40, 522
"c:\Users\Blessan Corley\My Projects\Fixly old\app\dashboard\find-fixers\page.js", "JavaScript", 0, 732, 0, 0, 0, 3, 63, 798
"c:\Users\Blessan Corley\My Projects\Fixly old\app\dashboard\jobs\[jobId]\apply\error.js", "JavaScript", 0, 56, 0, 0, 0, 0, 7, 63
"c:\Users\Blessan Corley\My Projects\Fixly old\app\dashboard\jobs\[jobId]\apply\page.js", "JavaScript", 0, 646, 0, 0, 0, 14, 52, 712
"c:\Users\Blessan Corley\My Projects\Fixly old\app\dashboard\jobs\[jobId]\edit\page.js", "JavaScript", 0, 624, 0, 0, 0, 7, 55, 686
"c:\Users\Blessan Corley\My Projects\Fixly old\app\dashboard\jobs\[jobId]\messages\page.js", "JavaScript", 0, 376, 0, 0, 0, 18, 41, 435
"c:\Users\Blessan Corley\My Projects\Fixly old\app\dashboard\jobs\[jobId]\page.js", "JavaScript", 0, 2657, 0, 0, 0, 27, 216, 2900
"c:\Users\Blessan Corley\My Projects\Fixly old\app\dashboard\jobs\page.js", "JavaScript", 0, 616, 0, 0, 0, 3, 63, 682
"c:\Users\Blessan Corley\My Projects\Fixly old\app\dashboard\layout.js", "JavaScript", 0, 931, 0, 0, 0, 12, 66, 1009
"c:\Users\Blessan Corley\My Projects\Fixly old\app\dashboard\messages\page.js", "JavaScript", 0, 639, 0, 0, 0, 27, 62, 728
"c:\Users\Blessan Corley\My Projects\Fixly old\app\dashboard\notifications\page.js", "JavaScript", 0, 522, 0, 0, 0, 6, 46, 574
"c:\Users\Blessan Corley\My Projects\Fixly old\app\dashboard\page.js", "JavaScript", 0, 758, 0, 0, 0, 3, 48, 809
"c:\Users\Blessan Corley\My Projects\Fixly old\app\dashboard\post-job\page.js", "JavaScript", 0, 1629, 0, 0, 0, 50, 188, 1867
"c:\Users\Blessan Corley\My Projects\Fixly old\app\dashboard\profile\page.js", "JavaScript", 0, 1025, 0, 0, 0, 20, 76, 1121
"c:\Users\Blessan Corley\My Projects\Fixly old\app\dashboard\settings\page.js", "JavaScript", 0, 1487, 0, 0, 0, 27, 100, 1614
"c:\Users\Blessan Corley\My Projects\Fixly old\app\dashboard\subscription\page.js", "JavaScript", 0, 875, 0, 0, 0, 9, 65, 949
"c:\Users\Blessan Corley\My Projects\Fixly old\app\error.js", "JavaScript", 0, 102, 0, 0, 0, 5, 12, 119
"c:\Users\Blessan Corley\My Projects\Fixly old\app\globals.css", "PostCSS", 0, 0, 0, 0, 583, 67, 148, 798
"c:\Users\Blessan Corley\My Projects\Fixly old\app\help\page.js", "JavaScript", 0, 923, 0, 0, 0, 8, 35, 966
"c:\Users\Blessan Corley\My Projects\Fixly old\app\how-it-works\page.js", "JavaScript", 0, 397, 0, 0, 0, 0, 27, 424
"c:\Users\Blessan Corley\My Projects\Fixly old\app\jobs\[jobId]\dispute\page.js", "JavaScript", 0, 580, 0, 0, 0, 1, 52, 633
"c:\Users\Blessan Corley\My Projects\Fixly old\app\jobs\[jobId]\page.js", "JavaScript", 0, 739, 0, 0, 0, 5, 51, 795
"c:\Users\Blessan Corley\My Projects\Fixly old\app\jobs\[jobId]\review\page.js", "JavaScript", 0, 587, 0, 0, 0, 3, 54, 644
"c:\Users\Blessan Corley\My Projects\Fixly old\app\layout.js", "JavaScript", 0, 109, 0, 0, 0, 2, 5, 116
"c:\Users\Blessan Corley\My Projects\Fixly old\app\loading.js", "JavaScript", 0, 16, 0, 0, 0, 1, 2, 19
"c:\Users\Blessan Corley\My Projects\Fixly old\app\not-found.js", "JavaScript", 0, 93, 0, 0, 0, 1, 8, 102
"c:\Users\Blessan Corley\My Projects\Fixly old\app\page.js", "JavaScript", 0, 550, 0, 0, 0, 1, 30, 581
"c:\Users\Blessan Corley\My Projects\Fixly old\app\pricing\page.js", "JavaScript", 0, 364, 0, 0, 0, 2, 19, 385
"c:\Users\Blessan Corley\My Projects\Fixly old\app\privacy\page.js", "JavaScript", 0, 296, 0, 0, 0, 1, 14, 311
"c:\Users\Blessan Corley\My Projects\Fixly old\app\profile\[username]\reviews\page.js", "JavaScript", 0, 595, 0, 0, 0, 2, 53, 650
"c:\Users\Blessan Corley\My Projects\Fixly old\app\providers.js", "JavaScript", 0, 294, 0, 0, 0, 28, 49, 371
"c:\Users\Blessan Corley\My Projects\Fixly old\app\resources\page.js", "JavaScript", 0, 462, 0, 0, 0, 0, 28, 490
"c:\Users\Blessan Corley\My Projects\Fixly old\app\safety\page.js", "JavaScript", 0, 469, 0, 0, 0, 0, 27, 496
"c:\Users\Blessan Corley\My Projects\Fixly old\app\search\page.js", "JavaScript", 0, 586, 0, 0, 0, 17, 41, 644
"c:\Users\Blessan Corley\My Projects\Fixly old\app\services\page.js", "JavaScript", 0, 315, 0, 0, 0, 0, 20, 335
"c:\Users\Blessan Corley\My Projects\Fixly old\app\support\page.js", "JavaScript", 0, 460, 0, 0, 0, 0, 32, 492
"c:\Users\Blessan Corley\My Projects\Fixly old\app\terms\page.js", "JavaScript", 0, 315, 0, 0, 0, 1, 11, 327
"c:\Users\Blessan Corley\My Projects\Fixly old\app\test\enhanced-signup\page.js", "JavaScript", 0, 363, 0, 0, 0, 0, 32, 395
"c:\Users\Blessan Corley\My Projects\Fixly old\app\test\location-picker\page.js", "JavaScript", 0, 303, 0, 0, 0, 0, 29, 332
"c:\Users\Blessan Corley\My Projects\Fixly old\components\CookieConsent.js", "JavaScript", 0, 79, 0, 0, 0, 2, 10, 91
"c:\Users\Blessan Corley\My Projects\Fixly old\components\InstagramCommentsRealtime.js", "JavaScript", 0, 559, 0, 0, 0, 19, 47, 625
"c:\Users\Blessan Corley\My Projects\Fixly old\components\JobCardRectangular.js", "JavaScript", 0, 381, 0, 0, 0, 14, 48, 443
"c:\Users\Blessan Corley\My Projects\Fixly old\components\JobCommentButton.js", "JavaScript", 0, 33, 0, 0, 0, 0, 4, 37
"c:\Users\Blessan Corley\My Projects\Fixly old\components\LocationPicker\EnhancedLocationSelector.js", "JavaScript", 0, 983, 0, 0, 0, 72, 109, 1164
"c:\Users\Blessan Corley\My Projects\Fixly old\components\LocationPicker\LocationPickerErrorBoundary.js", "JavaScript", 0, 122, 0, 0, 0, 5, 18, 145
"c:\Users\Blessan Corley\My Projects\Fixly old\components\LocationPicker\locationUtils.js", "JavaScript", 0, 250, 0, 0, 0, 20, 42, 312
"c:\Users\Blessan Corley\My Projects\Fixly old\components\SkillSelector\SkillSelector.js", "JavaScript", 0, 562, 0, 0, 0, 26, 38, 626
"c:\Users\Blessan Corley\My Projects\Fixly old\components\admin\AdminDashboard.js", "JavaScript", 0, 579, 0, 0, 0, 4, 39, 622
"c:\Users\Blessan Corley\My Projects\Fixly old\components\auth\FirebasePhoneAuth.js", "JavaScript", 0, 219, 0, 0, 0, 10, 36, 265
"c:\Users\Blessan Corley\My Projects\Fixly old\components\dashboard\VerificationPrompt.js", "JavaScript", 0, 259, 0, 0, 0, 5, 21, 285
"c:\Users\Blessan Corley\My Projects\Fixly old\components\dynamic\DynamicComponents.js", "JavaScript", 0, 371, 0, 0, 0, 26, 30, 427
"c:\Users\Blessan Corley\My Projects\Fixly old\components\jobs\RealTimeJobApplications.js", "JavaScript", 0, 406, 0, 0, 0, 15, 57, 478
"c:\Users\Blessan Corley\My Projects\Fixly old\components\jobs\VirtualJobList.js", "JavaScript", 0, 577, 0, 0, 0, 40, 76, 693
"c:\Users\Blessan Corley\My Projects\Fixly old\components\messages\MessagingStatus.js", "JavaScript", 0, 180, 0, 0, 0, 2, 14, 196
"c:\Users\Blessan Corley\My Projects\Fixly old\components\messages\RealTimeMessaging.js", "JavaScript", 0, 331, 0, 0, 0, 15, 40, 386
"c:\Users\Blessan Corley\My Projects\Fixly old\components\providers\QueryProvider.js", "JavaScript", 0, 203, 0, 0, 0, 21, 32, 256
"c:\Users\Blessan Corley\My Projects\Fixly old\components\reviews\ReviewForm.js", "JavaScript", 0, 439, 0, 0, 0, 1, 30, 470
"c:\Users\Blessan Corley\My Projects\Fixly old\components\search\AdvancedSearch.js", "JavaScript", 0, 442, 0, 0, 0, 12, 44, 498
"c:\Users\Blessan Corley\My Projects\Fixly old\components\search\EnhancedAdvancedSearch.js", "JavaScript", 0, 637, 0, 0, 0, 19, 57, 713
"c:\Users\Blessan Corley\My Projects\Fixly old\components\settings\PrivacyControls.js", "JavaScript", 0, 356, 0, 0, 0, 2, 15, 373
"c:\Users\Blessan Corley\My Projects\Fixly old\components\ui\ConfirmModal.js", "JavaScript", 0, 111, 0, 0, 0, 0, 8, 119
"c:\Users\Blessan Corley\My Projects\Fixly old\components\ui\DarkModeManager.js", "JavaScript", 0, 303, 0, 0, 0, 14, 22, 339
"c:\Users\Blessan Corley\My Projects\Fixly old\components\ui\ErrorBoundary.js", "JavaScript", 0, 176, 0, 0, 0, 4, 25, 205
"c:\Users\Blessan Corley\My Projects\Fixly old\components\ui\GlobalLoading.js", "JavaScript", 0, 109, 0, 0, 0, 19, 15, 143
"c:\Users\Blessan Corley\My Projects\Fixly old\components\ui\LoadingStates.js", "JavaScript", 0, 294, 0, 0, 0, 9, 30, 333
"c:\Users\Blessan Corley\My Projects\Fixly old\components\ui\LocationPermission.js", "JavaScript", 0, 286, 0, 0, 0, 8, 29, 323
"c:\Users\Blessan Corley\My Projects\Fixly old\components\ui\MobileNav.js", "JavaScript", 0, 283, 0, 0, 0, 6, 25, 314
"c:\Users\Blessan Corley\My Projects\Fixly old\components\ui\NotificationCenter.js", "JavaScript", 0, 252, 0, 0, 0, 6, 25, 283
"c:\Users\Blessan Corley\My Projects\Fixly old\components\ui\OnlineStatus.js", "JavaScript", 0, 370, 0, 0, 0, 13, 49, 432
"c:\Users\Blessan Corley\My Projects\Fixly old\components\ui\OptimizedImage.js", "JavaScript", 0, 298, 0, 0, 0, 6, 25, 329
"c:\Users\Blessan Corley\My Projects\Fixly old\components\ui\PWAInstallPrompt.js", "JavaScript", 0, 513, 0, 0, 0, 20, 68, 601
"c:\Users\Blessan Corley\My Projects\Fixly old\components\ui\ProBadge.js", "JavaScript", 0, 26, 0, 0, 0, 1, 5, 32
"c:\Users\Blessan Corley\My Projects\Fixly old\components\ui\PushNotificationManager.js", "JavaScript", 0, 135, 0, 0, 0, 7, 23, 165
"c:\Users\Blessan Corley\My Projects\Fixly old\components\ui\RealTimeCounter.js", "JavaScript", 0, 299, 0, 0, 0, 18, 38, 355
"c:\Users\Blessan Corley\My Projects\Fixly old\components\ui\RepostJobModal.js", "JavaScript", 0, 237, 0, 0, 0, 1, 20, 258
"c:\Users\Blessan Corley\My Projects\Fixly old\components\ui\ServiceWorkerRegistration.js", "JavaScript", 0, 83, 0, 0, 0, 17, 20, 120
"c:\Users\Blessan Corley\My Projects\Fixly old\components\ui\ThemeToggle.js", "JavaScript", 0, 163, 0, 0, 0, 2, 10, 175
"c:\Users\Blessan Corley\My Projects\Fixly old\components\ui\VerifiedBadge.js", "JavaScript", 0, 142, 0, 0, 0, 10, 21, 173
"c:\Users\Blessan Corley\My Projects\Fixly old\components\ui\VirtualList.js", "JavaScript", 0, 550, 0, 0, 0, 13, 29, 592
"c:\Users\Blessan Corley\My Projects\Fixly old\components\ui\VirtualizedNotificationList.js", "JavaScript", 0, 323, 0, 0, 0, 12, 43, 378
"c:\Users\Blessan Corley\My Projects\Fixly old\components\ui\mobile\MobileActionSheet.js", "JavaScript", 0, 83, 0, 0, 0, 0, 9, 92
"c:\Users\Blessan Corley\My Projects\Fixly old\components\ui\mobile\MobileBottomNav.js", "JavaScript", 0, 28, 0, 0, 0, 0, 1, 29
"c:\Users\Blessan Corley\My Projects\Fixly old\components\ui\mobile\MobileCard.js", "JavaScript", 0, 31, 0, 0, 0, 0, 2, 33
"c:\Users\Blessan Corley\My Projects\Fixly old\components\ui\mobile\MobileContactActions.js", "JavaScript", 0, 45, 0, 0, 0, 0, 3, 48
"c:\Users\Blessan Corley\My Projects\Fixly old\components\ui\mobile\MobileHeader.js", "JavaScript", 0, 87, 0, 0, 0, 0, 8, 95
"c:\Users\Blessan Corley\My Projects\Fixly old\components\ui\mobile\MobilePullToRefresh.js", "JavaScript", 0, 93, 0, 0, 0, 1, 13, 107
"c:\Users\Blessan Corley\My Projects\Fixly old\components\ui\mobile\MobileSafeArea.js", "JavaScript", 0, 15, 0, 0, 0, 0, 3, 18
"c:\Users\Blessan Corley\My Projects\Fixly old\components\ui\mobile\MobileScrollToTop.js", "JavaScript", 0, 35, 0, 0, 0, 0, 6, 41
"c:\Users\Blessan Corley\My Projects\Fixly old\components\ui\mobile\MobileSwipeCard.js", "JavaScript", 0, 39, 0, 0, 0, 0, 5, 44
"c:\Users\Blessan Corley\My Projects\Fixly old\components\ui\mobile\MobileTimeAgo.js", "JavaScript", 0, 30, 0, 0, 0, 0, 7, 37
"c:\Users\Blessan Corley\My Projects\Fixly old\components\ui\mobile\MobileVirtualList.js", "JavaScript", 0, 71, 0, 0, 0, 1, 11, 83
"c:\Users\Blessan Corley\My Projects\Fixly old\components\ui\mobile\index.js", "JavaScript", 0, 44, 0, 0, 0, 4, 3, 51
"c:\Users\Blessan Corley\My Projects\Fixly old\components\ui\mobile\useHapticFeedback.js", "JavaScript", 0, 21, 0, 0, 0, 0, 3, 24
"c:\Users\Blessan Corley\My Projects\Fixly old\components\ui\mobile\useMobileDevice.js", "JavaScript", 0, 53, 0, 0, 0, 1, 10, 64
"c:\Users\Blessan Corley\My Projects\Fixly old\components\ui\mobile\useTouchGestures.js", "JavaScript", 0, 80, 0, 0, 0, 4, 12, 96
"c:\Users\Blessan Corley\My Projects\Fixly old\contexts\AblyContext.js", "JavaScript", 0, 223, 0, 0, 0, 29, 56, 308
"c:\Users\Blessan Corley\My Projects\Fixly old\contexts\LoadingContext.js", "JavaScript", 0, 76, 0, 0, 0, 10, 18, 104
"c:\Users\Blessan Corley\My Projects\Fixly old\contexts\ThemeContext.js", "JavaScript", 0, 91, 0, 0, 0, 14, 25, 130
"c:\Users\Blessan Corley\My Projects\Fixly old\data\cities.js", "JavaScript", 0, 967, 0, 0, 0, 31, 35, 1033
"c:\Users\Blessan Corley\My Projects\Fixly old\data\validation.js", "JavaScript", 0, 22, 0, 0, 0, 1, 3, 26
"c:\Users\Blessan Corley\My Projects\Fixly old\hooks\useFirebase.js", "JavaScript", 0, 43, 0, 0, 0, 8, 13, 64
"c:\Users\Blessan Corley\My Projects\Fixly old\hooks\useLoadingTimeout.js", "JavaScript", 0, 90, 0, 0, 0, 15, 21, 126
"c:\Users\Blessan Corley\My Projects\Fixly old\hooks\useLocationTracking.js", "JavaScript", 0, 312, 0, 0, 0, 28, 55, 395
"c:\Users\Blessan Corley\My Projects\Fixly old\hooks\useMessaging.js", "JavaScript", 0, 299, 0, 0, 0, 31, 54, 384
"c:\Users\Blessan Corley\My Projects\Fixly old\hooks\useNetworkStatus.js", "JavaScript", 0, 58, 0, 0, 0, 6, 15, 79
"c:\Users\Blessan Corley\My Projects\Fixly old\hooks\usePageLoading.js", "JavaScript", 0, 66, 0, 0, 0, 6, 13, 85
"c:\Users\Blessan Corley\My Projects\Fixly old\hooks\useQuery.js", "JavaScript", 0, 384, 0, 0, 0, 30, 58, 472
"c:\Users\Blessan Corley\My Projects\Fixly old\hooks\useRealTimeNotifications.js", "JavaScript", 0, 252, 0, 0, 0, 24, 50, 326
"c:\Users\Blessan Corley\My Projects\Fixly old\hooks\useServiceWorker.js", "JavaScript", 0, 314, 0, 0, 0, 25, 62, 401
"c:\Users\Blessan Corley\My Projects\Fixly old\jest.setup.js", "JavaScript", 0, 360, 0, 0, 0, 26, 27, 413
"c:\Users\Blessan Corley\My Projects\Fixly old\jsconfig.json", "JSON with Comments", 14, 0, 0, 0, 0, 0, 0, 14
"c:\Users\Blessan Corley\My Projects\Fixly old\lib\ably.js", "JavaScript", 0, 173, 0, 0, 0, 37, 39, 249
"c:\Users\Blessan Corley\My Projects\Fixly old\lib\admin-notifications.js", "JavaScript", 0, 118, 0, 0, 0, 11, 36, 165
"c:\Users\Blessan Corley\My Projects\Fixly old\lib\analytics-client.js", "JavaScript", 0, 180, 0, 0, 0, 20, 27, 227
"c:\Users\Blessan Corley\My Projects\Fixly old\lib\apiSecurity.js", "JavaScript", 0, 317, 0, 0, 0, 74, 55, 446
"c:\Users\Blessan Corley\My Projects\Fixly old\lib\auth.js", "JavaScript", 0, 472, 0, 0, 0, 100, 76, 648
"c:\Users\Blessan Corley\My Projects\Fixly old\lib\cache.js", "JavaScript", 0, 114, 0, 0, 0, 9, 22, 145
"c:\Users\Blessan Corley\My Projects\Fixly old\lib\contentValidation.js", "JavaScript", 0, 380, 0, 0, 0, 63, 79, 522
"c:\Users\Blessan Corley\My Projects\Fixly old\lib\db.js", "JavaScript", 0, 161, 0, 0, 0, 29, 33, 223
"c:\Users\Blessan Corley\My Projects\Fixly old\lib\email.js", "JavaScript", 0, 320, 0, 0, 0, 11, 20, 351
"c:\Users\Blessan Corley\My Projects\Fixly old\lib\errorHandling.js", "JavaScript", 0, 321, 0, 0, 0, 38, 56, 415
"c:\Users\Blessan Corley\My Projects\Fixly old\lib\firebase-admin.js", "JavaScript", 0, 24, 0, 0, 0, 1, 5, 30
"c:\Users\Blessan Corley\My Projects\Fixly old\lib\firebase-client.js", "JavaScript", 0, 15, 0, 0, 0, 2, 3, 20
"c:\Users\Blessan Corley\My Projects\Fixly old\lib\firebase.js", "JavaScript", 0, 140, 0, 0, 0, 11, 33, 184
"c:\Users\Blessan Corley\My Projects\Fixly old\lib\inputSanitization.js", "JavaScript", 0, 540, 0, 0, 0, 19, 12, 571
"c:\Users\Blessan Corley\My Projects\Fixly old\lib\locationTracking.js", "JavaScript", 0, 302, 0, 0, 0, 38, 61, 401
"c:\Users\Blessan Corley\My Projects\Fixly old\lib\mongodb.js", "JavaScript", 0, 82, 0, 0, 0, 10, 8, 100
"c:\Users\Blessan Corley\My Projects\Fixly old\lib\notifications.js", "JavaScript", 0, 438, 0, 0, 0, 44, 79, 561
"c:\Users\Blessan Corley\My Projects\Fixly old\lib\otpService.js", "JavaScript", 0, 214, 0, 0, 0, 12, 20, 246
"c:\Users\Blessan Corley\My Projects\Fixly old\lib\rateLimit.js", "JavaScript", 0, 219, 0, 0, 0, 59, 47, 325
"c:\Users\Blessan Corley\My Projects\Fixly old\lib\reactQuery.js", "JavaScript", 0, 282, 0, 0, 0, 54, 48, 384
"c:\Users\Blessan Corley\My Projects\Fixly old\lib\redis.js", "JavaScript", 0, 302, 0, 0, 0, 32, 54, 388
"c:\Users\Blessan Corley\My Projects\Fixly old\lib\redisCache.js", "JavaScript", 0, 272, 0, 0, 0, 67, 60, 399
"c:\Users\Blessan Corley\My Projects\Fixly old\lib\services\automatedMessaging.js", "JavaScript", 0, 340, 0, 0, 0, 38, 74, 452
"c:\Users\Blessan Corley\My Projects\Fixly old\lib\services\locationHistoryService.js", "JavaScript", 0, 376, 0, 0, 0, 35, 73, 484
"c:\Users\Blessan Corley\My Projects\Fixly old\lib\services\messageService.js", "JavaScript", 0, 326, 0, 0, 0, 49, 62, 437
"c:\Users\Blessan Corley\My Projects\Fixly old\lib\services\notificationService.js", "JavaScript", 0, 391, 0, 0, 0, 73, 76, 540
"c:\Users\Blessan Corley\My Projects\Fixly old\lib\services\userTriggeredCleanup.js", "JavaScript", 0, 124, 0, 0, 0, 32, 31, 187
"c:\Users\Blessan Corley\My Projects\Fixly old\lib\services\webPushService.js", "JavaScript", 0, 251, 0, 0, 0, 25, 48, 324
"c:\Users\Blessan Corley\My Projects\Fixly old\lib\simple-realtime.js", "JavaScript", 0, 80, 0, 0, 0, 16, 16, 112
"c:\Users\Blessan Corley\My Projects\Fixly old\lib\validations\content-validator.js", "JavaScript", 0, 547, 0, 0, 0, 84, 86, 717
"c:\Users\Blessan Corley\My Projects\Fixly old\lib\whatsapp.js", "JavaScript", 0, 106, 0, 0, 0, 15, 25, 146
"c:\Users\Blessan Corley\My Projects\Fixly old\middleware.js", "JavaScript", 0, 87, 0, 0, 0, 16, 17, 120
"c:\Users\Blessan Corley\My Projects\Fixly old\models\Conversation.js", "JavaScript", 0, 192, 0, 0, 0, 11, 15, 218
"c:\Users\Blessan Corley\My Projects\Fixly old\models\Dispute.js", "JavaScript", 0, 381, 0, 0, 0, 12, 23, 416
"c:\Users\Blessan Corley\My Projects\Fixly old\models\Job.js", "JavaScript", 0, 1318, 0, 0, 0, 97, 152, 1567
"c:\Users\Blessan Corley\My Projects\Fixly old\models\JobDraft.js", "JavaScript", 0, 427, 0, 0, 0, 42, 54, 523
"c:\Users\Blessan Corley\My Projects\Fixly old\models\LocationPreference.js", "JavaScript", 0, 276, 0, 0, 0, 27, 28, 331
"c:\Users\Blessan Corley\My Projects\Fixly old\models\Review.js", "JavaScript", 0, 293, 0, 0, 0, 11, 20, 324
"c:\Users\Blessan Corley\My Projects\Fixly old\models\User.js", "JavaScript", 0, 1322, 0, 0, 0, 93, 105, 1520
"c:\Users\Blessan Corley\My Projects\Fixly old\models\VerificationToken.js", "JavaScript", 0, 124, 0, 0, 0, 8, 16, 148
"c:\Users\Blessan Corley\My Projects\Fixly old\next-sitemap.config.js", "JavaScript", 0, 51, 0, 0, 0, 1, 0, 52
"c:\Users\Blessan Corley\My Projects\Fixly old\next.config.js", "JavaScript", 0, 172, 0, 0, 0, 19, 19, 210
"c:\Users\Blessan Corley\My Projects\Fixly old\package-lock.json", "JSON", 0, 0, 0, 19890, 0, 0, 1, 19891
"c:\Users\Blessan Corley\My Projects\Fixly old\package-scripts.json", "JSON", 0, 0, 0, 6, 0, 0, 0, 6
"c:\Users\Blessan Corley\My Projects\Fixly old\package.json", "JSON", 0, 0, 0, 193, 0, 0, 1, 194
"c:\Users\Blessan Corley\My Projects\Fixly old\postcss.config.js", "JavaScript", 0, 6, 0, 0, 0, 1, 1, 8
"c:\Users\Blessan Corley\My Projects\Fixly old\scripts\apply-security.js", "JavaScript", 0, 194, 0, 0, 0, 11, 9, 214
"c:\Users\Blessan Corley\My Projects\Fixly old\scripts\demo-content-protection.js", "JavaScript", 0, 227, 0, 0, 0, 16, 27, 270
"c:\Users\Blessan Corley\My Projects\Fixly old\scripts\demo-content-validation.js", "JavaScript", 0, 176, 0, 0, 0, 13, 23, 212
"c:\Users\Blessan Corley\My Projects\Fixly old\scripts\final-comprehensive-test.js", "JavaScript", 0, 245, 0, 0, 0, 11, 52, 308
"c:\Users\Blessan Corley\My Projects\Fixly old\scripts\fix-duplicate-usernames.js", "JavaScript", 0, 94, 0, 0, 0, 14, 25, 133
"c:\Users\Blessan Corley\My Projects\Fixly old\scripts\generate-pwa-icons.js", "JavaScript", 0, 75, 0, 0, 0, 7, 13, 95
"c:\Users\Blessan Corley\My Projects\Fixly old\scripts\reset-redis-test-data.js", "JavaScript", 0, 78, 0, 0, 0, 8, 19, 105
"c:\Users\Blessan Corley\My Projects\Fixly old\scripts\test-address-form-improvements.js", "JavaScript", 0, 257, 0, 0, 0, 12, 66, 335
"c:\Users\Blessan Corley\My Projects\Fixly old\scripts\test-api-functionality.js", "JavaScript", 0, 182, 0, 0, 0, 18, 37, 237
"c:\Users\Blessan Corley\My Projects\Fixly old\scripts\test-app-functionality.js", "JavaScript", 0, 208, 0, 0, 0, 13, 46, 267
"c:\Users\Blessan Corley\My Projects\Fixly old\scripts\test-auth-performance.js", "JavaScript", 0, 329, 0, 0, 0, 20, 83, 432
"c:\Users\Blessan Corley\My Projects\Fixly old\scripts\test-auth-system.js", "JavaScript", 0, 234, 0, 0, 0, 20, 53, 307
"c:\Users\Blessan Corley\My Projects\Fixly old\scripts\test-complete-auth-flows.js", "JavaScript", 0, 314, 0, 0, 0, 23, 60, 397
"c:\Users\Blessan Corley\My Projects\Fixly old\scripts\test-complete-location-integration.js", "JavaScript", 0, 209, 0, 0, 0, 16, 49, 274
"c:\Users\Blessan Corley\My Projects\Fixly old\scripts\test-complete-otp-flow.js", "JavaScript", 0, 234, 0, 0, 0, 16, 46, 296
"c:\Users\Blessan Corley\My Projects\Fixly old\scripts\test-complete-realtime-system.js", "JavaScript", 0, 360, 0, 0, 0, 29, 79, 468
"c:\Users\Blessan Corley\My Projects\Fixly old\scripts\test-db-connection.js", "JavaScript", 0, 31, 0, 0, 0, 3, 9, 43
"c:\Users\Blessan Corley\My Projects\Fixly old\scripts\test-enhanced-location-picker.js", "JavaScript", 0, 173, 0, 0, 0, 18, 49, 240
"c:\Users\Blessan Corley\My Projects\Fixly old\scripts\test-enhanced-location-system.js", "JavaScript", 0, 342, 0, 0, 0, 30, 78, 450
"c:\Users\Blessan Corley\My Projects\Fixly old\scripts\test-enhanced-maps-apis.js", "JavaScript", 0, 256, 0, 0, 0, 22, 49, 327
"c:\Users\Blessan Corley\My Projects\Fixly old\scripts\test-enhanced-push-notifications.js", "JavaScript", 0, 138, 0, 0, 0, 19, 40, 197
"c:\Users\Blessan Corley\My Projects\Fixly old\scripts\test-final-auth-verification.js", "JavaScript", 0, 266, 0, 0, 0, 13, 68, 347
"c:\Users\Blessan Corley\My Projects\Fixly old\scripts\test-fixer-job-system.js", "JavaScript", 0, 454, 0, 0, 0, 33, 95, 582
"c:\Users\Blessan Corley\My Projects\Fixly old\scripts\test-index-initialization.js", "JavaScript", 0, 25, 0, 0, 0, 7, 9, 41
"c:\Users\Blessan Corley\My Projects\Fixly old\scripts\test-india-location-service.js", "JavaScript", 0, 308, 0, 0, 0, 19, 69, 396
"c:\Users\Blessan Corley\My Projects\Fixly old\scripts\test-job-application-system.js", "JavaScript", 0, 319, 0, 0, 0, 22, 60, 401
"c:\Users\Blessan Corley\My Projects\Fixly old\scripts\test-location-integration.js", "JavaScript", 0, 352, 0, 0, 0, 27, 62, 441
"c:\Users\Blessan Corley\My Projects\Fixly old\scripts\test-location-picker.js", "JavaScript", 0, 258, 0, 0, 0, 17, 57, 332
"c:\Users\Blessan Corley\My Projects\Fixly old\scripts\test-location-service.js", "JavaScript", 0, 261, 0, 0, 0, 24, 42, 327
"c:\Users\Blessan Corley\My Projects\Fixly old\scripts\test-memory-leaks.js", "JavaScript", 0, 223, 0, 0, 0, 46, 66, 335
"c:\Users\Blessan Corley\My Projects\Fixly old\scripts\test-optimized-auth-system.js", "JavaScript", 0, 287, 0, 0, 0, 21, 56, 364
"c:\Users\Blessan Corley\My Projects\Fixly old\scripts\test-otp-endpoints.js", "JavaScript", 0, 217, 0, 0, 0, 15, 36, 268
"c:\Users\Blessan Corley\My Projects\Fixly old\scripts\test-real-api-endpoints.js", "JavaScript", 0, 263, 0, 0, 0, 27, 60, 350
"c:\Users\Blessan Corley\My Projects\Fixly old\scripts\test-real-connections.js", "JavaScript", 0, 117, 0, 0, 0, 13, 38, 168
"c:\Users\Blessan Corley\My Projects\Fixly old\scripts\test-redis-connection.js", "JavaScript", 0, 159, 0, 0, 0, 22, 45, 226
"c:\Users\Blessan Corley\My Projects\Fixly old\scripts\test-redis-integration.js", "JavaScript", 0, 302, 0, 0, 0, 54, 89, 445
"c:\Users\Blessan Corley\My Projects\Fixly old\scripts\test-review-system.mjs", "JavaScript", 0, 332, 0, 0, 0, 35, 63, 430
"c:\Users\Blessan Corley\My Projects\Fixly old\scripts\test-security.js", "JavaScript", 0, 405, 0, 0, 0, 56, 83, 544
"c:\Users\Blessan Corley\My Projects\Fixly old\scripts\test-skill-selector.js", "JavaScript", 0, 220, 0, 0, 0, 32, 64, 316
"c:\Users\Blessan Corley\My Projects\Fixly old\scripts\test-skills-api-integration.js", "JavaScript", 0, 246, 0, 0, 0, 40, 67, 353
"c:\Users\Blessan Corley\My Projects\Fixly old\scripts\test-unified-auth-system.js", "JavaScript", 0, 282, 0, 0, 0, 21, 86, 389
"c:\Users\Blessan Corley\My Projects\Fixly old\scripts\test-unified-realtime-job-system.js", "JavaScript", 0, 254, 0, 0, 0, 14, 51, 319
"c:\Users\Blessan Corley\My Projects\Fixly old\scripts\test-unified-signup-flow.js", "JavaScript", 0, 271, 0, 0, 0, 12, 72, 355
"c:\Users\Blessan Corley\My Projects\Fixly old\scripts\test-upstash-connection.js", "JavaScript", 0, 101, 0, 0, 0, 12, 19, 132
"c:\Users\Blessan Corley\My Projects\Fixly old\scripts\validate-database-integrity.js", "JavaScript", 0, 509, 0, 0, 0, 26, 76, 611
"c:\Users\Blessan Corley\My Projects\Fixly old\scripts\validate-database-integrity.mjs", "JavaScript", 0, 262, 0, 0, 0, 41, 52, 355
"c:\Users\Blessan Corley\My Projects\Fixly old\scripts\validate-realtime-integration.js", "JavaScript", 0, 123, 0, 0, 0, 14, 26, 163
"c:\Users\Blessan Corley\My Projects\Fixly old\scripts\verify-auth-implementation.js", "JavaScript", 0, 287, 0, 0, 0, 25, 62, 374
"c:\Users\Blessan Corley\My Projects\Fixly old\scripts\verify-implementation.js", "JavaScript", 0, 211, 0, 0, 0, 16, 40, 267
"c:\Users\Blessan Corley\My Projects\Fixly old\styles\mobile.css", "PostCSS", 0, 0, 0, 0, 243, 30, 44, 317
"c:\Users\Blessan Corley\My Projects\Fixly old\tailwind.config.js", "JavaScript", 0, 165, 0, 0, 0, 12, 11, 188
"c:\Users\Blessan Corley\My Projects\Fixly old\test-api-endpoints.js", "JavaScript", 0, 88, 0, 0, 0, 4, 24, 116
"c:\Users\Blessan Corley\My Projects\Fixly old\test-google-oauth.js", "JavaScript", 0, 34, 0, 0, 0, 4, 10, 48
"c:\Users\Blessan Corley\My Projects\Fixly old\test-mongodb-simple.js", "JavaScript", 0, 40, 0, 0, 0, 4, 11, 55
"c:\Users\Blessan Corley\My Projects\Fixly old\test-real-connections.js", "JavaScript", 0, 117, 0, 0, 0, 12, 34, 163
"c:\Users\Blessan Corley\My Projects\Fixly old\test-signup-simple.js", "JavaScript", 0, 58, 0, 0, 0, 2, 13, 73
"c:\Users\Blessan Corley\My Projects\Fixly old\tests\ablyIntegration.test.js", "JavaScript", 0, 525, 0, 0, 0, 11, 141, 677
"c:\Users\Blessan Corley\My Projects\Fixly old\tests\apiEndpoints.test.js", "JavaScript", 0, 520, 0, 0, 0, 13, 140, 673
"c:\Users\Blessan Corley\My Projects\Fixly old\tests\comprehensive-endpoint-tests.js", "JavaScript", 0, 484, 0, 0, 0, 35, 97, 616
"c:\Users\Blessan Corley\My Projects\Fixly old\tests\endToEndWorkflows.test.js", "JavaScript", 0, 762, 0, 0, 0, 38, 123, 923
"c:\Users\Blessan Corley\My Projects\Fixly old\tests\locationTracking.test.js", "JavaScript", 0, 480, 0, 0, 0, 33, 101, 614
"c:\Users\Blessan Corley\My Projects\Fixly old\tests\redisIntegration.test.js", "JavaScript", 0, 386, 0, 0, 0, 33, 109, 528
"c:\Users\Blessan Corley\My Projects\Fixly old\tests\simple.test.js", "JavaScript", 0, 27, 0, 0, 0, 1, 6, 34
"c:\Users\Blessan Corley\My Projects\Fixly old\tests\userRoles.test.js", "JavaScript", 0, 716, 0, 0, 0, 16, 102, 834
"c:\Users\Blessan Corley\My Projects\Fixly old\utils\bundleOptimization.js", "JavaScript", 0, 438, 0, 0, 0, 22, 29, 489
"c:\Users\Blessan Corley\My Projects\Fixly old\utils\creditUtils.js", "JavaScript", 0, 74, 0, 0, 0, 40, 23, 137
"c:\Users\Blessan Corley\My Projects\Fixly old\utils\emailService.js", "JavaScript", 0, 271, 0, 0, 0, 12, 22, 305
"c:\Users\Blessan Corley\My Projects\Fixly old\utils\errorHandling.js", "JavaScript", 0, 353, 0, 0, 0, 31, 71, 455
"c:\Users\Blessan Corley\My Projects\Fixly old\utils\locationUtils.js", "JavaScript", 0, 177, 0, 0, 0, 19, 28, 224
"c:\Users\Blessan Corley\My Projects\Fixly old\utils\performance.js", "JavaScript", 0, 298, 0, 0, 0, 37, 70, 405
"c:\Users\Blessan Corley\My Projects\Fixly old\utils\performanceMonitoring.js", "JavaScript", 0, 578, 0, 0, 0, 73, 106, 757
"c:\Users\Blessan Corley\My Projects\Fixly old\utils\rateLimiting.js", "JavaScript", 0, 234, 0, 0, 0, 32, 36, 302
"c:\Users\Blessan Corley\My Projects\Fixly old\utils\sensitiveContentFilter.js", "JavaScript", 0, 101, 0, 0, 0, 27, 18, 146
"c:\Users\Blessan Corley\My Projects\Fixly old\utils\smsService.js", "JavaScript", 0, 84, 0, 0, 0, 106, 21, 211
"c:\Users\Blessan Corley\My Projects\Fixly old\utils\toast.js", "JavaScript", 0, 140, 0, 0, 0, 13, 12, 165
"c:\Users\Blessan Corley\My Projects\Fixly old\utils\validation.js", "JavaScript", 0, 671, 0, 0, 0, 68, 104, 843
"c:\Users\Blessan Corley\My Projects\Fixly old\vercel.json", "JSON", 0, 0, 0, 60, 0, 0, 0, 60
"Total", "-", 14, 95521, 3091, 20149, 826, 5852, 13708, 139161